1111111111111111111111111111111111111111111111
1P1000010000100100000000000000000C000000010001
1010010100101010010000000001001001000000010101
1010001000000000101001000101001001000000010101
1010010010101011101001001000001010000000000101
1000010000010000000001000100000000001000000101
101000100100000000010000100000000C000000010001
1010010100100000000001000000000000000000010101
1010010100101010101001001000000000000000010101
1010010001000000000101010101101001001000010101
1000010000100000000000010000000001001000000101
101000010010000000000000100000000C000000010001
1010010100101001010010000000001001000000010101
1010010100101001010100100000001010000000000101
1010010010010101110100100100001010000000000101
10000100000010000000001001000000100000000001E1
1111111111111111111111111111111111111111111111