11111111111111111111111111111111111111
1010010C100001000001000101010000000111
10100101100001011010000001001000111111
10100101100110000000000100010000111111
1P000000C00C000101000100010001E0111111
11111111111111111111111111111111111111