1111111111111111111111111111111111
1P1000010000100000000C000000010001
1010010100101010101001000000010101
1010010100101010101001000000010101
1010010010101011101001001000010101
1000010000010000000001001000000101
101000010000100000000C000000010001
1010010100101010101001000000010101
1010010100101010101001000000010101
1010010010101011101001001000010101
1000010000010000000001001000000101
101000010000100000000C000000010001
1010010100101010101001000000010101
1010010100101010101001000000010101
1010010010101011101001001000010101
10000100000100000000010010000001E1
1111111111111111111111111111111111