1111111111111111111111111111111111
100000000000000C00000C000000000001
1010010100100000101001000000010101
1010010010101010001000000000010101
10000000C00C0000000000100000011111
100000000000000C000001100011100001
1010010100100000101001001000010101
1010010010101010001001001000010101
1P000000C00C00000000010010000001E1
1111111111111111111111111111111111