111111111111
1010C0010001
1P00010001E1
111111111111