11111111111111111111111111111111
10100100101010100010010000010001
1P000000C00C000000000001000001E1
11111111111111111111111111111111