1111111111111111111111111111111111111111111111111111
1P1000010000100100000000000000000C000000010001000011
1010010100101010010000000001001001000000101001001011
1010001000000000101001000101001001000000010100001101
1010010010101011101001001000001010000000000101000001
1000010000010000000001000100000000010000001000010101
1010001001010000011000000001000010000000000000010001
1010010100100000000001000000000000000010000011010101
1010010010100000000101010101101001000100000110110101
1000010000100000000000100000110000001011100000011111
101000010010000000000000100000000C011111100000010001
1010010100101001010010000000001001000011000000010101
1010010100110010101010000011111000011011000000000101
1010010010100000110101011101001001000000000010000011
1000010000001000000001001000000100000000001000001111
1010010100101010101000001110010010000000000000000101
1010010001000000000101010101010010010000101011000011
1000010000100000000000010000000010010000001010111111
1010000101000001100100000000000010000000C00000001001
1010010100101001010010000000001001000000010101000001
1010010100101001010100100000001010000000001010011001
1010010010010010000011101110100100100001100000011011
100001000000100000000100100000010000000000111100E001
1111111111111111111111111111111111111111111111111111