111111111111111111111111111111
1010000C100C101000000110000001
101001011001101000000100010001
1P000000C00C0000001000010001E1
111111111111111111111111111111