111111111111111111111111111111
1010010C100C101000100100010001
101001011001101000100100010001
1P000000C00C0000000000010001E1
111111111111111111111111111111